@^.^~****^
*.#*~*.~^^^
^^*#**~.*^*
*~~.#~^.~*~
*.^~^#^.~^.
^.^^~^#.*~*
*~~.*.^#~~~
.~.*~~^*#.*
.^^^~~*~.#^
^^^*^^**.X#
