@^.^~****^
*.*~*.~^^^
^^***~.*^*
*~~.~^.~*~
*.^~^^.~^.
^.^^~^.*~*
*~~.*.^~~~
.~.*~~^*.*
.^^^~~*~.^
^^^*^^**.X